NO ./textures/piet/piet5.xpm
SO ./textures/piet/piet3.xpm
WE ./textures/piet/piet2.xpm
EA ./textures/piet/piet.xpm


C 130, 130, 130
F 42, 42, 42

11111111111111111111111111111111111111111111111111111111111
10000000000000000000000000000000000000000000000000000000001
1E000000000000000000000000000000000000000000000000000000001
10000000000000000000000000000000000000000000000000000000001
11111111111110000000000000000000000000000000000000000000001
10000000000010000000000000000000000000000000000000000000001
10000000000010000000000000000000000000000000000000000000001
10000000000010000000000000000000000000000000000000000000001
10000000000010000000000000000000000000000000000000000000001
10000000000000000000000000000000000000000000000000000000001
10000000000000000000000000000000000000000000000000000000001
11111111111111111111111111111111111111111111111111111111111

