NO ./textures/NO.xpm
SO ./textures/SO.xpm
WE ./textures/WE.xpm
EA ./textures/EA.xpm

F 0, 255  , 0
C 0,  0,255

111    111
101    101
101    1011111
101111110000001
1000N000011111
1111111111