NO ./textures/basic/NO.xpm
SO ./textures/basic/SO.xpm
WE ./textures/basic/WE.xpm
EA ./textures/basic/EA.xpm


F 122,  122, 122
C 42,  42,42

        1111111111111111111111111
        1000000000110000000000001
        1011000001110000001000001
        1001000000000000000001001
111111111011000001110000000000001
100000000011000001110111110111111
11110111111111011100000010001
11110111111111011101010010001
11000000110101011100000010001
10001000000000001100000010001
10000000000000001101010010001
11000001110101011111011110N01
11110111111101011101111010001
11111111111111111111111111111
