NO ./textures/musee/magritte.xpm
SO ./textures/musee/picasso.xpm
WE ./textures/musee/mc.xpm
EA ./textures/musee/vangogh.xpm


C 200, 200, 200
F 42, 42, 42

1111111111111111111111111111111111111111
1000000000001110000000001110000000000001
1000001110001110001110001110001110100101
1000001110001110001110001110001110011001
1000001110001110001110001110001110100101
100N001110000000001110000000001110000001
1111111111111111111111111111111111111111
